NO ./textures/no.xpm
SO ./textures/so.xpm
WE ./textures/we.xpm
EA ./textures/ea.xpm
F 220,100,0
C 225,30,0

11111 
10N001
10000 
111111
