NO ./textures/no.xpm
SO ./textures/so.xpm
WE ./textures/we.xpm
EA ./textures/ea.xpm
F 220,100,0
C 225,30,0

111111
10A0N1
100001
111111
