NO ./textures/no.xpm
SO ./textures/so.xpm
WE ./textures/we.xpm
EA ./textures/ea.xpm
F 300,0,0
C 225,30,0

111111
1000N1
100001
111111
