NO ./textures/no.xpm
SO ./textures/so.xpm
WE ./textures/we.xpm
EA ./textures/ea.xpm
F 90,90,90
C 160,160,220

1111111111111
1N00000000001
1111111111101
1000000000101
1011111110101
1010000010101
1010111010101
1010100010101
1010111010101
1010000010101
1011111110101
1000000000001
1111111111111
