NO ./textures/no.xpm
SO ./textures/so.xpm
WE ./textures/we.xpm
EA ./textures/ea.xpm
F 180,180,180
C 60,60,80

11111111111111111111
10000000000000000001
10N00000000000111001
10000000000000000001
10001000111110000001
10000000000000000001
10000010000000000001
10000010000000000001
10000010000000000001
10000010000000000001
10000010011000000001
10000000001000000001
10001110011000000001
10000000000000100101
10000000011000100101
10000000000000100101
10000000000000000001
10000000000000000001
10000000000000000001
10000000000000000001
10000000000000000001
10000000000000000001
10000000000000000001
10000000000000000001
10000000000000000001
10000000000000000001
10000000000000000001
10000000000000000001
10000000000000000001
11111111111111111111
