NO ./textures/no.xpm
SO ./textures/so.xpm
WE ./textures/we.xpm
EA ./textures/ea.xpm
F 180,180,180
C 60,60,80

111111
1S0001
111111
