NO ./textures/no.xpm
SO ./textures/so.xpm
WE ./textures/we.xpm




EA ./textures/ea.xpm
F 220,100,0
C 225,30,0

  1111
1110N1
100001
111111
