NO ./textures/no.xpm
SO ./textures/so.xpm
WE ./textures/we.xpm
EA ./textures/ea.xpm
F 180,180,180
C 60,60,80

111111111111
1N0000000001
101111011111
100001010001
111101010111
100001010001
101111011101
100000000001
111111111111
